111111111111111
111000000011101
10100000001P101
101111111100101
100000C0000E101
111111111111111