11111111111111111111111111111111111
1P00000000C0000000000E1111111111111
11111111111111111111111111111111111