# **************************************************************************** #
#                                                                              #
#                                                         :::      ::::::::    #
#    maps.ber                                           :+:      :+:    :+:    #
#                                                     +:+ +:+         +:+      #
#    By: pafuente <pafuente@student.42malaga.com    +#+  +:+       +#+         #
#                                                 +#+#+#+#+#+   +#+            #
#    Created: 2025/05/09 12:47:42 by pafuente          #+#    #+#              #
#    Updated: 2025/05/09 12:47:49 by pafuente         ###   ########.fr        #
#                                                                              #
# **************************************************************************** #

11111
1P0C1
10001
1C0E1
11111
