111111111
1P0E000C1
111111111

