11111111111111111111111111111111111
11111110001111111111111111111111111
1P000000E0C000000000001001000000001
11111111111111111111111111111111111